@@@@@@@@@@@@@@@@@@@@@@@@@@@@@@@@@@@@@@@@@@@@@@@@@@@@@@@@@@@@
@..........................................................@
@..........................................................@
@..........................................................@
@..........................................................@
@..........................................................@
@..........................................................@
@..........................................................@
@..........................................................@
@..........................................................@
@..........................................................@
@..........................................................@
@..........................................................@
@..........................................................@
@..........................................................@
@..........................................................@
@..........................................................@
@..........................................................@
@..........................................................@
@..........................................................@
@..........................................................@
@..........................................................@
@..........................................................@
@..........................................................@
@..........................................................@
@.....................##############.......................@
@.....................##############.......................@
@.....................##############.......................@
@.....................##############.......................@
@.....................##############.......................@
@..........................................................@
@..........................................................@
@..........................................................@
@..........................................................@
@..........................................................@
@..........................................................@
@..........................................................@
@..........................................................@
@..........................................................@
@..........................................................@
@..........................................................@
@..........................................................@
@..........................................................@
@..........................................................@
@..........................................................@
@..........................................................@
@..........................................................@
@@@@@@@@@@@@@@@@@@@@@@@@@@@@@@@@@@@@@@@@@@@@@@@@@@@@@@@@@@@@